20
1 1 1 1 1 1 1 1 1 1 1 1 1 1 1 1 1 1 1 1
1 0 0 0 0 0 0 0 0 0 0 0 0 0 0 0 0 0 0 1
1 0 0 0 0 0 0 0 7 1 1 7 1 7 7 1 0 0 0 1
1 0 0 0 0 0 0 0 1 0 0 0 0 0 0 7 0 0 0 1
1 0 0 0 0 0 7 1 1 0 1 7 1 1 0 7 1 1 1 1
1 0 0 0 0 0 7 0 0 0 0 7 0 0 0 0 0 0 1 1
1 1 1 1 7 7 7 0 1 1 0 1 0 1 0 1 0 1 1 1
1 0 0 0 0 0 0 3 1 0 0 1 0 7 0 7 0 7 0 1
1 0 1 1 1 7 1 1 1 1 0 1 0 1 0 1 0 1 0 1
1 0 7 1 0 0 0 0 0 0 3 1 0 1 0 1 0 1 0 1
1 3 7 1 0 1 7 1 1 1 1 1 0 1 0 1 0 1 0 1
1 0 7 1 0 0 0 0 0 0 1 0 0 1 0 1 0 1 0 1
7 0 1 7 0 1 1 7 1 0 7 0 0 1 3 1 3 1 0 1
1 0 1 7 0 7 0 0 1 0 1 0 0 1 0 7 0 1 0 1
1 0 7 1 0 1 0 0 1 0 1 0 0 1 0 1 0 1 0 1
1 0 1 7 0 1 0 7 1 0 1 1 0 1 0 1 0 1 0 1
1 0 0 0 3 1 0 7 0 0 0 1 3 1 0 0 0 1 0 1
1 7 1 1 7 1 0 1 0 2 0 7 5 1 7 1 1 1 0 1
1 0 0 0 0 0 0 7 0 0 0 7 6 1 0 0 0 0 0 1
1 1 1 1 1 1 1 1 1 1 1 1 1 1 1 1 1 1 1 1