40
1 1 1 1 1 1 1 1 1 1 1 1 1 1 1 1 1 1 1 1 1 1 1 1 1 1 1 1 1 1 1 1 1 1 1 1 1 1 1 1
1 0 0 0 0 0 0 0 0 0 0 0 0 0 0 0 0 0 0 0 0 0 0 0 0 0 0 0 0 0 0 0 0 0 0 0 0 0 0 1
1 0 0 0 0 0 0 0 0 0 0 1 1 1 1 1 1 1 0 0 0 0 0 0 0 0 0 0 0 0 0 0 0 0 0 0 0 0 0 1
1 0 0 0 0 0 0 0 0 0 0 1 0 0 0 0 0 1 0 0 0 0 0 0 0 0 0 0 0 0 0 0 0 0 0 0 0 0 0 1
1 0 0 0 0 0 0 0 0 1 7 7 0 8 0 8 0 1 1 7 7 1 1 1 1 1 1 1 1 1 7 1 1 1 1 1 1 0 0 1
1 0 0 0 0 0 0 0 0 1 0 0 0 0 11 0 0 0 0 0 0 0 0 0 0 0 0 0 0 0 3 0 0 0 0 0 1 0 0 1
1 0 0 0 0 0 0 0 0 1 0 7 0 8 0 8 0 1 1 1 1 0 1 1 1 7 1 1 7 1 1 1 7 1 7 0 1 0 0 1
1 0 0 0 0 0 1 7 7 7 0 1 0 0 0 0 0 1 0 0 7 0 1 0 0 0 0 0 0 0 3 0 0 0 1 0 1 0 0 1
1 0 0 0 0 0 1 0 0 3 0 1 0 0 3 0 0 1 0 0 7 0 1 6 0 0 0 0 0 0 0 0 0 0 1 0 1 0 0 1
1 0 0 0 1 1 1 0 0 0 0 1 1 1 7 1 1 1 0 0 7 0 1 6 6 6 3 0 0 0 0 0 0 0 1 0 1 0 0 1
1 0 0 0 1 3 0 0 0 0 0 0 3 1 0 0 0 0 0 0 1 3 1 6 5 0 0 0 0 0 0 0 0 0 0 0 1 0 0 1
1 0 0 0 1 1 1 0 0 0 0 1 1 1 0 0 0 0 0 0 1 0 1 6 6 6 3 0 0 0 0 0 0 0 1 0 1 0 0 1
1 0 0 0 0 0 1 0 0 0 0 1 0 0 0 0 0 0 0 0 1 0 7 6 0 0 0 0 0 0 0 0 0 0 1 0 1 0 0 1
1 0 0 0 0 0 1 0 0 0 0 1 0 0 0 0 0 0 0 0 1 0 7 0 0 0 0 0 0 0 0 0 0 0 7 0 1 0 0 1
1 0 0 0 0 0 1 1 1 0 1 1 0 1 1 1 1 1 0 0 1 0 1 0 0 0 0 0 0 0 3 0 0 0 1 0 1 0 0 1
1 0 0 0 0 0 0 0 1 0 1 0 0 1 0 0 0 1 0 0 1 0 7 1 1 1 1 1 1 1 1 1 1 7 1 3 1 9 9 1
1 0 0 0 0 0 0 0 7 0 1 0 0 1 0 2 0 1 0 0 1 0 0 0 0 0 0 0 0 0 0 0 3 7 1 0 1 0 9 1
1 0 0 0 1 1 1 1 1 0 1 0 0 1 0 0 0 1 0 0 1 0 1 1 1 1 1 1 1 1 1 1 1 7 1 0 1 9 9 1
1 0 0 0 1 0 0 0 0 0 1 0 0 1 1 0 1 1 0 0 1 3 1 0 0 0 0 0 0 0 0 0 0 0 1 0 1 8 8 1
1 0 0 0 1 0 1 1 1 3 1 0 8 8 7 0 7 8 8 0 1 0 1 0 0 0 0 0 0 0 0 0 0 0 1 0 0 11 8 1
1 0 7 7 1 0 1 0 7 0 7 0 8 11 0 0 0 11 8 0 1 0 1 0 1 1 1 1 7 7 7 7 7 7 7 0 1 8 8 1
1 1 1 0 0 0 1 0 1 0 1 0 8 8 7 0 7 8 8 0 1 0 1 0 1 0 0 0 0 0 3 0 0 0 0 0 1 0 0 1
1 1 0 0 1 1 1 0 1 0 1 0 0 0 1 0 1 0 0 0 1 0 1 0 1 0 1 7 7 7 1 1 7 7 7 1 1 0 0 1
1 1 0 1 1 0 0 0 1 0 1 0 0 0 1 0 1 0 0 0 1 0 1 0 1 0 0 0 0 3 0 0 0 0 7 0 0 0 0 1
1 1 0 1 0 0 0 0 1 0 1 0 0 0 1 3 1 0 0 0 1 0 1 0 1 1 1 1 1 1 1 1 1 0 1 0 0 0 0 1
1 1 0 1 1 7 1 7 1 0 1 1 1 1 7 0 7 1 1 1 1 0 1 1 7 1 1 1 1 1 1 1 1 0 1 0 0 0 0 1
1 1 0 1 1 0 0 0 0 3 0 0 0 0 0 0 0 0 0 0 0 3 0 0 0 0 0 0 0 0 0 3 7 0 1 0 0 0 0 1
1 1 0 1 7 0 1 1 1 0 1 1 1 1 7 7 7 1 1 1 1 0 1 1 1 1 0 0 0 0 0 0 7 0 1 0 0 0 0 1
1 1 3 1 1 0 1 0 7 0 7 0 0 0 0 0 0 0 0 0 1 0 1 0 0 1 0 0 0 0 0 0 7 0 1 0 0 0 0 1
1 1 0 7 1 0 1 0 1 0 1 1 1 7 1 7 1 1 1 1 7 0 1 0 0 1 0 0 0 3 0 0 0 0 1 0 0 0 0 1
1 7 0 7 1 3 1 0 1 0 0 0 0 0 0 3 0 0 0 0 0 0 7 0 0 1 7 7 7 1 1 1 1 1 1 0 0 0 0 1
1 7 0 1 1 0 1 1 1 7 1 1 1 7 1 1 1 1 1 1 1 1 7 0 0 0 0 0 0 0 0 0 0 0 0 0 0 0 0 1
1 7 0 0 0 0 0 0 0 7 0 0 0 0 0 0 0 0 0 0 0 0 0 0 0 0 0 0 0 0 0 0 0 0 0 0 0 0 0 1
1 7 3 0 0 9 0 9 0 7 0 0 0 0 0 0 0 0 0 0 0 0 0 0 0 0 0 0 0 0 0 0 0 0 0 0 0 0 0 1
1 7 0 0 0 0 12 0 0 1 0 0 0 0 0 0 0 0 0 0 0 0 0 0 0 0 0 0 0 0 0 0 0 0 0 0 0 0 0 1
1 7 0 0 0 9 0 9 0 1 0 0 0 0 0 0 0 0 0 0 0 0 0 0 0 0 0 0 0 0 0 0 0 0 0 0 0 0 0 1
1 7 1 1 0 0 0 0 0 1 0 0 0 0 0 0 0 0 0 0 0 0 0 0 0 0 0 0 0 0 0 0 0 0 0 0 0 0 0 1
1 0 0 1 1 1 1 1 1 1 0 0 0 0 0 0 0 0 0 0 0 0 0 0 0 0 0 0 0 0 0 0 0 0 0 0 0 0 0 1
1 0 0 0 0 0 0 0 0 0 0 0 0 0 0 0 0 0 0 0 0 0 0 0 0 0 0 0 0 0 0 0 0 0 0 0 0 0 0 1
1 1 1 1 1 1 1 1 1 1 1 1 1 1 1 1 1 1 1 1 1 1 1 1 1 1 1 1 1 1 1 1 1 1 1 1 1 1 1 1