30
1 1 1 1 1 1 1 1 1 1 1 1 1 1 1 1 1 1 1 1 1 1 1 1 1 1 1 1 1 1
1 0 0 0 0 0 0 0 0 0 0 0 0 0 0 0 0 0 0 0 0 0 0 0 0 0 0 0 0 1
1 0 7 1 1 1 7 7 7 7 1 1 1 0 0 0 0 0 0 0 0 0 0 0 0 0 0 0 0 1
1 0 7 0 0 0 0 0 3 0 0 0 1 0 0 0 0 0 0 0 0 0 0 0 0 0 0 0 0 1
1 0 1 3 7 1 7 7 7 7 1 0 1 0 0 0 0 0 0 0 0 0 0 0 0 0 0 0 0 1
1 0 1 0 1 0 0 0 0 0 1 3 1 0 0 0 0 0 0 0 0 0 0 1 1 1 1 1 1 1
1 0 1 0 1 0 0 0 0 0 1 0 1 0 0 0 0 0 0 0 0 0 0 1 0 0 0 0 0 1
1 0 1 0 1 0 0 0 0 0 1 0 1 0 1 1 1 1 1 1 1 1 1 1 0 6 0 6 0 1
1 0 1 0 1 0 0 0 0 1 1 0 1 0 1 0 0 0 0 1 0 0 0 0 0 0 5 0 0 1
1 0 1 0 1 0 0 0 0 7 0 0 1 0 1 8 0 8 0 1 3 1 1 1 0 6 0 6 0 1
1 1 1 0 1 1 1 1 1 1 0 7 1 0 1 0 11 0 0 0 0 1 0 1 0 0 0 0 0 1
1 0 3 0 0 0 0 0 0 0 0 7 0 0 1 8 0 8 0 1 0 1 0 1 1 1 1 1 1 1
1 1 1 0 1 1 1 1 1 0 1 1 0 0 1 0 0 0 0 1 0 1 0 0 0 0 0 0 0 1
1 0 0 0 0 0 0 0 7 0 7 0 0 1 7 7 7 7 7 1 0 1 0 0 0 0 0 0 0 1
1 0 9 0 9 0 1 7 1 0 1 0 0 1 0 0 0 0 3 0 0 1 0 0 0 0 0 0 0 1
1 0 0 12 0 0 1 3 0 0 1 0 0 1 0 7 1 1 1 1 1 1 0 0 0 0 0 0 0 1
1 0 9 0 9 0 1 0 1 1 1 1 1 1 0 7 0 0 0 0 0 0 0 0 0 0 0 0 0 1
1 0 0 0 0 0 1 0 7 0 0 0 0 0 0 7 0 0 0 0 0 0 0 0 0 0 0 0 0 1
1 0 0 0 0 0 1 0 1 0 0 0 0 1 0 7 0 0 0 0 0 0 0 0 0 0 0 0 0 1
1 1 7 1 1 0 1 0 1 0 0 0 0 7 3 1 1 1 1 1 1 1 0 0 0 0 0 0 0 1
1 8 0 8 1 1 1 0 1 1 1 1 1 1 0 1 0 0 0 0 0 1 0 0 0 0 0 0 0 1
1 0 11 0 0 0 0 0 0 0 0 1 1 1 0 1 0 9 0 9 0 1 0 0 0 0 0 0 0 1
1 8 0 8 1 1 7 0 1 1 0 1 1 7 0 0 0 0 12 0 0 1 0 0 0 0 0 0 0 1
1 1 7 1 1 1 1 0 1 0 0 0 0 7 0 7 0 9 0 9 0 1 0 0 0 0 0 0 0 1
1 0 0 0 1 3 0 0 1 7 3 7 1 1 0 1 0 0 0 0 0 1 0 0 0 0 0 0 0 1
1 1 1 1 1 0 1 1 1 1 0 7 1 7 0 1 1 1 1 1 1 1 0 0 0 0 0 0 0 1
1 0 0 0 7 0 1 0 0 7 0 0 0 3 0 1 0 0 0 0 0 0 0 0 0 0 0 0 0 1
1 0 2 0 0 0 1 0 0 1 1 7 1 1 1 1 0 0 0 0 0 0 0 0 0 0 0 0 0 1
1 0 0 0 7 1 1 0 0 0 0 0 0 0 0 0 0 0 0 0 0 0 0 0 0 0 0 0 0 1
1 1 1 1 1 1 1 1 1 1 1 1 1 1 1 1 1 1 1 1 1 1 1 1 1 1 1 1 1 1