15
1 1 1 1 1 1 1 1 1 1 1 1 1 1 1
1 6 6 6 1 0 0 0 1 3 0 0 0 0 1
1 6 5 0 0 0 1 0 1 0 8 0 8 0 1
1 6 6 6 1 1 1 0 0 0 0 11 0 0 1
1 1 1 1 1 1 7 1 1 0 8 0 8 3 1
1 1 0 0 0 0 0 0 1 0 0 0 0 0 1
1 1 0 0 0 0 1 0 1 0 0 0 0 0 1
1 7 0 7 0 3 1 0 0 0 0 0 0 0 1
1 1 0 7 1 1 1 0 1 7 1 7 1 1 1
1 0 0 0 0 0 0 0 0 0 0 0 0 3 1
1 0 7 1 1 1 7 0 1 1 1 1 1 7 1
1 0 1 0 0 1 0 0 0 1 0 0 0 0 1
1 0 1 7 0 7 0 2 0 1 0 0 0 0 1
1 0 0 0 3 1 0 0 0 7 0 0 0 0 1
1 1 7 1 1 1 1 1 1 1 1 1 1 1 1